<6><5>
<3>
<E><E><E><E><E><E>
<E><S><N><G><N><E>
<E><N><S><N><O><E>
<E><G><O><S><N><E>
<E><E><E><E><E><E>
