<6><5>
<0>
<E><E><E><E><E><E>
<E><S><N><O><S><E>
<E><N><S><N><G><E>
<E><O><G><S><N><E>
<E><E><E><E><E><E>
