<5><5>
<E><E><F><F><E>
<E><N><O><N><E>
<E><G><N><N><E>
<E><S><S><S><E>
<E><E><E><E><E>