<30><30>
<E><E><E><E><E><E><E><E><E><E><E><E><E><E><E><E><E><E><E><E><E><E><E><E><E><E><E><E><E><E>
<E><E><E><E><E><E><E><E><E><E><E><E><E><E><E><E><E><E><E><E><E><E><E><E><E><E><E><E><E><E>
<E><E><E><E><N><N><N><N><N><N><N><N><N><N><E><E><E><E><E><E><E><E><E><E><E><E><E><E><E><E>
<E><E><E><N><N><N><N><N><N><N><N><N><N><N><N><N><E><E><E><E><E><E><E><E><E><E><E><E><E><E>
<E><E><E><N><N><N><N><N><N><N><N><N><N><N><N><N><N><N><N><N><E><E><E><E><E><E><E><E><E><E>
<E><E><E><N><N><N><N><E><N><N><N><E><N><N><N><N><N><N><N><N><N><N><N><E><E><E><E><E><E><E>
<E><E><E><N><N><N><N><E><E><N><N><E><E><N><N><N><N><N><N><N><N><N><N><N><E><E><E><E><E><E>
<E><E><E><E><N><N><N><N><E><E><N><N><E><N><N><N><N><N><N><N><N><N><N><N><N><E><E><E><E><E>
<E><E><E><E><N><N><N><N><E><E><N><N><E><E><E><E><E><E><E><E><E><E><N><N><N><N><N><E><E><E>
<E><E><E><E><E><N><N><N><N><E><N><N><E><E><E><E><E><E><E><E><E><E><E><N><N><N><N><E><E><E>
<E><E><E><E><E><E><N><N><N><E><N><N><E><E><E><E><E><E><E><E><E><E><E><E><N><N><N><E><E><E>
<E><E><E><E><E><E><N><N><N><E><N><N><N><N><N><N><E><E><E><E><E><E><E><E><N><N><N><E><E><E>
<E><E><E><E><E><N><N><N><E><E><N><N><N><N><N><N><N><N><E><E><E><E><E><N><N><N><N><E><E><E>
<E><E><E><E><E><N><N><N><E><E><E><E><E><E><E><N><N><N><N><E><E><E><N><N><N><N><E><E><E><E>
<E><E><E><E><N><N><N><E><E><E><E><E><E><E><E><E><E><N><N><N><E><N><N><N><N><E><E><E><E><E>
<E><E><E><N><N><N><E><E><E><E><E><E><E><E><E><E><E><E><N><N><N><N><N><N><E><E><E><E><E><E>
<E><E><E><N><N><N><E><E><E><E><E><E><E><E><E><E><E><E><E><N><N><N><N><N><N><E><E><E><E><E>
<E><E><E><N><N><N><E><E><E><E><E><E><E><E><E><E><E><E><E><E><E><N><N><N><N><E><E><E><E><E>
<E><E><N><N><E><N><N><N><E><E><E><E><E><E><E><E><E><E><E><E><E><E><E><N><N><N><E><E><E><E>
<E><E><N><N><E><E><N><N><E><E><E><E><E><E><E><E><E><E><E><E><E><E><E><N><N><N><N><E><E><E>
<E><E><N><N><E><E><N><N><E><E><E><E><E><E><E><E><E><E><E><E><E><E><E><N><N><N><N><N><E><E>
<E><N><N><E><E><N><N><E><E><E><E><E><E><E><E><E><E><E><E><E><E><E><E><E><N><N><N><N><E><E>
<E><N><N><E><E><N><N><E><E><E><E><E><E><E><E><E><E><E><E><E><E><E><E><E><N><N><N><N><E><E>
<E><N><N><E><E><N><N><E><E><E><E><E><E><E><E><E><E><E><E><E><E><E><E><N><N><N><N><N><E><E>
<E><N><N><N><N><N><N><E><E><E><E><E><E><E><E><E><E><E><E><E><E><N><N><N><N><N><N><N><E><E>
<E><N><N><N><N><N><N><E><E><E><E><E><E><E><E><E><E><E><E><N><N><N><N><N><N><N><N><E><E><E>
<E><N><S><N><N><S><N><E><E><E><E><E><E><E><N><N><N><N><N><N><N><N><N><N><N><N><E><E><E><E>
<E><N><N><N><N><N><N><N><N><N><N><N><N><N><N><N><N><N><N><N><N><N><N><N><N><E><E><E><E><E>
<E><N><N><N><N><N><N><N><N><N><N><N><N><N><N><N><N><N><N><N><N><N><N><N><E><E><E><E><E><E>
<E><E><E><E><E><E><E><E><E><E><E><E><E><E><E><E><E><E><E><E><E><E><E><E><E><E><E><E><E><E>