<40><23>
<E><E><E><E><E><E><E><E><E><E><E><E><E><E><E><E><E><E><E><E><E><E><E><E><E><E><E><E><E><E><E><E><E><E><E><E><E><E><E><E>
<E><S><N><E><E><E><E><E><E><E><N><N><N><N><N><N><E><E><E><E><E><E><E><E><E><E><E><E><E><E><E><E><E><E><E><E><E><E><F><E>
<E><N><N><N><E><E><E><E><E><N><N><N><N><N><N><N><N><N><E><E><E><E><E><E><E><E><E><E><E><E><E><E><E><E><E><E><E><E><N><E>
<E><E><N><N><N><E><E><E><N><N><N><E><E><E><E><N><N><N><N><N><N><N><E><E><E><E><E><E><E><N><N><N><N><N><N><E><E><E><N><E>
<E><E><E><N><N><N><N><N><N><N><E><E><E><E><E><E><E><N><N><N><N><N><N><N><N><N><N><N><N><N><N><N><N><N><N><N><N><N><N><E>
<E><E><E><E><N><N><N><N><N><E><E><E><E><E><E><E><E><E><E><E><N><N><N><N><N><N><N><N><N><N><N><E><E><E><N><N><N><N><N><E>
<E><E><E><E><E><E><E><E><E><E><E><E><E><E><E><E><E><E><E><E><E><E><E><E><E><E><E><E><E><E><E><E><E><E><E><E><E><E><E><E>
<E><E><E><E><E><E><E><E><E><E><E><E><E><E><E><E><E><E><E><E><E><E><E><E><E><E><E><E><E><E><E><E><E><E><E><E><E><E><E><E>
<E><E><E><E><E><E><E><E><E><E><E><E><E><E><E><E><E><E><E><E><E><E><E><E><E><E><E><E><E><E><E><E><E><E><E><E><E><E><E><E>
<E><S><N><E><E><E><E><E><E><E><N><N><N><N><N><N><E><E><E><E><E><E><E><E><E><E><E><E><E><E><E><E><E><E><E><E><E><E><F><E>
<E><N><N><N><E><E><E><E><E><N><N><N><N><N><N><N><N><N><E><E><E><E><E><E><E><E><E><E><E><E><E><E><E><E><E><E><E><E><N><E>
<E><E><N><N><N><E><E><E><N><N><N><E><E><E><E><N><N><N><N><N><N><N><E><E><E><E><E><E><E><N><N><N><N><N><N><E><E><E><N><E>
<E><E><E><N><N><N><N><N><N><N><E><E><E><E><E><E><E><N><N><N><N><N><N><N><N><N><N><N><N><N><N><N><N><N><N><N><N><N><N><E>
<E><E><E><E><N><N><N><N><N><E><E><E><E><E><E><E><E><E><E><E><N><N><N><N><N><N><N><N><N><N><N><E><E><E><N><N><N><N><N><E>
<E><E><E><E><E><E><E><E><E><E><E><E><E><E><E><E><E><E><E><E><E><E><E><E><E><E><E><E><E><E><E><E><E><E><E><E><E><E><E><E>
<E><E><E><E><E><E><E><E><E><E><E><E><E><E><E><E><E><E><E><E><E><E><E><E><E><E><E><E><E><E><E><E><E><E><E><E><E><E><E><E>
<E><E><E><E><E><E><E><E><E><E><E><E><E><E><E><E><E><E><E><E><E><E><E><E><E><E><E><E><E><E><E><E><E><E><E><E><E><E><E><E>
<E><S><N><E><E><E><E><E><E><E><N><N><N><N><N><N><E><E><E><E><E><E><E><E><E><E><E><E><E><E><E><E><E><E><E><E><E><E><F><E>
<E><N><N><N><E><E><E><E><E><N><N><N><N><N><N><N><N><N><E><E><E><E><E><E><E><E><E><E><E><E><E><E><E><E><E><E><E><E><N><E>
<E><E><N><N><N><E><E><E><N><N><N><E><E><E><E><N><N><N><N><N><N><N><E><E><E><E><E><E><E><N><N><N><N><N><N><E><E><E><N><E>
<E><E><E><N><N><N><N><N><N><N><E><E><E><E><E><E><E><N><N><N><N><N><N><N><N><N><N><N><N><N><N><N><N><N><N><N><N><N><N><E>
<E><E><E><E><N><N><N><N><N><E><E><E><E><E><E><E><E><E><E><E><N><N><N><N><N><N><N><N><N><N><N><E><E><E><N><N><N><N><N><E>
<E><E><E><E><E><E><E><E><E><E><E><E><E><E><E><E><E><E><E><E><E><E><E><E><E><E><E><E><E><E><E><E><E><E><E><E><E><E><E><E>